NO texture/north_texture.xpm
SO texture/south_texture.xpm
WE texture/west_texture.xpm
EA texture/east_texture.xpm
F 220, 100,0
C                   225    ,           30 ,               0







        111111111111111111111111
        1000000000110000000000001
        1011000001110000011N00001
        1001000000000000011000001
111111111011000001110000000000001
10000000001100000111011111111111
11110111111111011100000001111
1111011111111101110101001
11000000110101011100000001111
10000000000000001100000000001
10000000000000001101010010001
1100000111010101111101111000111
11110111 1110111 101111010001
11111111 1111111 11111111111

